100 5 3 0
Sa.a.a.a.
a a a a b
.a.a.a.b.
a a b a b
.a.b.bDb.