110 5 3 1
Sa.a. .b.
a a b   b
.a. .b.b.
  a b b b
.a. .bDb.
