70 5 3 0
Sa.a.a.a.
a a c c c
.a.a.c.c.
b b b c c
.b.b.bDc.