40 10 9 0
.b.b. .a. .a.a. . .
b b b   a a a   a a
.bSa.a.a. .a.a.a.a.
  b b   a a a      
.b.b. . .a.a.e.e.e.
b   c   c   a   e e
.b.b.b. .c. .a.e.e.
    c   c c   a e  
.c. .c.c. .c. .a.a.
c c   c   c c   a a
.c.c.c. . .a.a.a. .
d     d d a c     a
.d.d.d.d.d.a.a.a.a.
    d d   d   a   a
.d.d.d.d.d. .a. .a.
d d   d d   a   a a
. . .d.dDa.a. .a.a.